R      640    480
NO                   ./textures/wall4.xpm
SO          ./textures/wall1.xpm
WE ./textures/wall2.xpm
EA ./textures/wall3.xpm

S ./textures/chu.xpm
F             9,24,34
C           45,75,96


        1111111111111111111111111
        1000000000110000000000001
        101100000111000W001002001
        1001000000000000000000001
111111111011020001110002000200001
100000000011000001110111111111111
11110111111111011100000010001
11110111111111011101010010201
11000000110101011100000010001
10002000000000001100000000001
10000000000000001101010000001
1100000111010101111101111000111
11110111 1110101 101111010001
11111111 1111111 111111111111
