R 640 480
NO ./textures/wall4.xpm
SO ./textures/wall1.xpm
WE ./textures/wall2.xpm
EA ./textures/wall3.xpm

S ./textures/chu.xpm
F 9,24,34
C 45,75,96


1111111111111111111111111
1000000000000000000000001
1000000000000000000000001
1000000000222000000000001
1000000002222220000000001
1000000022222222000000001
1000000002222200000000001
1000000000000000000000001
10000000000N0000000000001
1000000000000000000000001
1111111111111111111111111
