11111111111111
1E001100000001
10000000000001
10000011P00001
100C0000000001
11111111111111