11111111111111
1E001100000001
1000000000C001
10000011P00001
100C0000000001
11111111111111