11111111111111
1E001100000001
1000C00000C001
10000111000001
10000000000P01
11111111111111