11111111111111
1E001100000001
1000000000C001
10000C11P00001
10000000000001
11111111111111