1111111111111111111
1E001100C00C0000001
1S0000000000010C001
100001111P000S00001
1S0C00000000000C001
1111111111111111111