1111111111111111111
1E001100C00C0000001
100000000S00010C001
10000S11P0000S00001
100C0000S000000C001
1111111111111111111