1111111111111111111111111111
1ES000000000C00000C000000001
1010010100100001000SSS010101
1010010010101010001000010101
1P0000000C00C000S000000000C1
1111111111111111111111111111