1111111111111111111111111111
10000000000P0000000000000001
100000000000000C000000000001
1000S00000000000000000000001
1000000C00000000000C00000001
10000000C0000000000000000001
1000000000000000000000C00001
100000000000100000000C000001
100000C000001000000000000001
100000000100000000000C000001
1000000000001000000C000C0001
1000000000001000000000000001
1000C0000000000000000000S001
10000000E00000000000C0000001
1000000C000000000E00000C0001
1000000000000000000000000001
1111111111111111111111111111