1111111111111111111
1E001100C00C0000001
100000000000010C001
10000011P0000000001
100C00000000000C001
1111111111111111111