1111111111
10000000C1
100P000SE1
1111111111