1111111111
1P000000C1
11000000E1
1111111111